{
    "name": "Cave",
    "player_spawn": [10, 10],
    "map": [
        [1,1,1,1,1,1,1,1,1,1,1,1,1,1,1,1,1,1,1,1],
        [1,0,0,0,0,0,0,0,0,0,0,0,0,0,0,0,0,0,0,1],
        [1,0,0,0,0,0,0,0,0,0,0,0,0,0,0,0,0,0,0,1],
        [1,0,0,0,1,1,1,0,0,0,0,1,1,0,0,0,0,0,0,1],
        [1,0,0,0,1,0,0,0,0,0,0,0,1,0,0,0,0,0,0,1],
        [1,0,0,0,1,0,0,0,0,0,0,0,1,1,1,1,0,0,0,1],
        [1,0,0,0,0,0,0,0,0,0,0,0,0,0,0,0,0,0,0,1],
        [1,0,0,0,0,0,0,0,0,0,0,0,0,0,0,0,0,0,0,1],
        [1,0,0,0,0,0,0,0,0,0,0,0,0,0,0,0,0,0,0,1],
        [1,0,0,0,0,0,0,0,0,0,0,0,0,0,0,0,0,0,0,1],
        [1,0,0,0,0,0,0,0,0,0,0,0,0,0,0,0,0,0,0,1],
        [1,0,0,0,0,0,0,0,0,0,0,0,0,0,0,0,0,0,0,1],
        [1,0,0,0,0,0,0,0,0,0,0,0,0,0,0,0,0,0,0,1],
        [1,0,0,0,0,0,0,0,0,0,0,0,0,0,0,0,0,0,0,1],
        [1,0,0,0,0,0,0,0,0,0,0,0,0,0,0,0,0,0,0,1],
        [1,0,0,0,0,0,0,0,0,0,0,0,0,0,0,0,0,0,0,1],
        [1,0,0,0,0,0,0,0,0,0,0,0,0,0,0,0,0,0,0,1],
        [1,0,0,0,0,0,0,0,0,0,0,0,0,0,0,0,0,0,0,1],
        [1,0,0,0,0,0,0,0,0,0,0,0,0,0,0,0,0,0,0,1],
        [1,1,1,1,1,1,1,1,1,1,1,1,1,1,1,1,1,1,1,1]
    ],
    "static_lights": [
        {"id": 0, "x": 3, "y": 3, "radius_cells": 4, "intensity": 0.7, "color": [255, 180, 100]},
        {"id": 1, "x": 16, "y": 4, "radius_cells": 3, "intensity": 0.5, "color": [100, 200, 255]},
        {"id": 2, "x": 5, "y": 16, "radius_cells": 5, "intensity": 0.6, "color": [200, 100, 255]},
        {"id": 3, "x": 14, "y": 15, "radius_cells": 2, "intensity": 0.4, "color": [255, 100, 100]}
    ],
    "dynamic_objects": [
        {"id": 0, "x": 8, "y": 8, "light_radius": 2, "light_intensity": 0.4, "color": [200, 80, 80]},
        {"id": 1, "x": 12, "y": 12, "light_radius": 1.5, "light_intensity": 0.3, "color": [80, 200, 80]}
    ],
    "bots": [
        {"id": 0, "x": 7, "y": 7, "light_radius": 2, "light_intensity": 0.5, "color": [255, 80, 80], "speed": 1.8},
        {"id": 1, "x": 15, "y": 8, "light_radius": 2, "light_intensity": 0.4, "color": [80, 80, 255], "speed": 1.2}
    ]
}
