{
    "name": "Room",
    "player_spawn": [7, 5],
    "map": [
        [1,1,1,1,1,1,1,1,1,1,1,1,1,1,1,1,1,1,1,1],
        [1,0,0,0,0,0,0,0,0,1,0,0,0,0,0,0,0,0,0,1],
        [1,0,0,0,0,0,0,0,0,1,0,0,0,0,0,0,0,0,0,1],
        [1,0,0,0,0,0,0,0,0,0,0,0,0,0,0,0,0,0,0,1],
        [1,0,0,0,0,0,0,0,0,0,0,0,0,0,0,0,0,0,0,1],
        [1,0,0,0,0,0,0,0,0,0,0,0,0,0,0,0,0,0,0,1],
        [1,0,0,0,0,0,0,0,0,0,0,0,0,0,0,0,0,0,0,1],
        [1,0,0,0,0,0,0,0,0,1,0,0,0,0,0,0,0,0,0,1],
        [1,0,0,0,0,0,0,0,0,1,0,0,0,0,0,0,0,0,0,1],
        [1,1,1,1,1,0,1,1,1,1,1,1,1,0,1,1,1,1,1,1],
        [1,0,0,0,0,0,0,0,0,1,0,0,0,0,0,0,0,0,0,1],
        [1,0,0,0,0,0,0,0,0,1,0,0,0,0,0,0,0,0,0,1],
        [1,0,0,0,0,0,0,0,0,0,0,0,0,0,0,0,0,0,0,1],
        [1,0,0,0,0,0,0,0,0,0,0,0,0,0,0,0,0,0,0,1],
        [1,0,0,0,0,0,0,0,0,0,0,0,0,0,0,0,0,0,0,1],
        [1,0,0,0,0,0,0,0,0,0,0,0,0,0,0,0,0,0,0,1],
        [1,0,0,0,0,0,0,0,0,1,0,0,0,0,0,0,0,0,0,1],
        [1,0,0,0,0,0,0,0,0,1,0,0,0,0,0,0,0,0,0,1],
        [1,0,0,0,0,0,0,0,0,0,0,0,0,0,0,0,0,0,0,1],
        [1,1,1,1,1,1,1,1,1,1,1,1,1,1,1,1,1,1,1,1]
    ],
    "static_lights": [
        {"id": 0, "x": 4, "y": 4, "radius_cells": 5, "intensity": 0.9, "color": [255, 220, 180]},
        {"id": 1, "x": 15, "y": 4, "radius_cells": 4, "intensity": 0.7, "color": [255, 200, 150]},
        {"id": 2, "x": 4, "y": 14, "radius_cells": 4, "intensity": 0.7, "color": [200, 200, 255]},
        {"id": 3, "x": 15, "y": 14, "radius_cells": 5, "intensity": 0.8, "color": [255, 180, 200]}
    ],
    "dynamic_objects": [
        {"id": 0, "x": 10, "y": 6, "light_radius": 1.5, "light_intensity": 0.3, "color": [100, 100, 100]},
        {"id": 1, "x": 12, "y": 12, "light_radius": 2, "light_intensity": 0.4, "color": [220, 100, 100]}
    ],
    "bots": [
        {"id": 0, "x": 12, "y": 5, "light_radius": 2.5, "light_intensity": 0.5, "color": [0, 150, 255], "speed": 1.5},
        {"id": 1, "x": 8, "y": 14, "light_radius": 2, "light_intensity": 0.4, "color": [255, 100, 100], "speed": 1.8}
    ]
}
